NO    maps/map1.cub  
SO      maps/map1.cub  
EA      maps/map1.cub
WE      maps/map1.cub
F       234,234,234
C       234,234,234

1111111111111111111111111
1000000000011000000000001
10N0000001110000000000001
1000000000000000000000001
111111111011000001110000111110001
100000000011000001110101111111111
11110111111111011100000010001
11110111111111011101010010001
10000000110101011100000010001
100W0000000000001100000010001
10000001110000011110100100001
11110111 1110101 101111010011
11111111 1111111 111111111111

