NO    maps/map1.cub  
SO      maps/map1.cub  
EA      maps/map1.cub
WE      maps/map1.cub
F       234,234,234
C       234,234,234

111111111111111111111111111111111
10000000000000011111000000000001
100000000000000000001000000000001
10000000000000N000000100000000001
100000000000000000000000000000001
100000000000000000000000000000001
100000000000000000000000000000001
100000000000000000000000000000001
100000000000000000000000000000001
100W00000000000000000000100000001
100000000000000000000000000000001
111111111111111111111111111111111

