NO    maps/map1.cub  
SO      maps/map1.cub  
EA      maps/map1.cub
WE      maps/map1.cub
F       234,234,234
C       234,234,234

111111111111111
100000000000001
100000000000001
100000000000001
100000000000001
1000000000000N1
100000000000001
100000000000001
100000000000001
100000000000001
111111111111111
