NO      Texture/1.xpm
SO      Texture/2.xpm
EA      Texture/3.xpm
WE      Texture/4.xpm

F       153,153,153
C       60,200,200

        1111111111111111111111111
        1000000001100000000000001
        1011000001110000000000001
        1001000000000000000000001
111111111011000001110000111110001
100000000011000001110101111111111
11110111111111011100000010001
11110111111111011101010010001
10000000110101011100000010001
10000000E00000001100000010001
10000001110000011110100100001
11110111 1110101 11111010011
11111111 1111111 111111111111