NO              ./Textures/1.xpm

    WE     ./Textures/2.xpm

 SO ./Textures/3.xpm


EA .Textures/4.xpm

F     108,172,1

C 22,163,247
         

11111111111111111111111111111111111111111111111
11111111111110000000000000111111111111111111111
11111111111110000000000000111111111111111111111
11111111111110000000000000111111111111111111111
11111111111110000000000000111111111111111111111
11111111111110000000000000111111111111111111111
11111111111110000000000000111111111111111111111
11111111111111111101111111111111111111111111111
11111111111111111000111111111111111111111111111
11111111111111111101111111111111111111111111111
11111111111111111001111111111111111111111111111
11111111111111111100111111111111111111111111111
11111111111111111000111111111111111111111111111
11111111111111111101111111111111111111111111111
11111111111111111101111111111111111111111111111
11111111111111111001111111111111111111111111111
11111111111111111100111111111111111111111111111
11111111111111111000111111111111111111111111111
11111111111111111101111111111111111111111111111
11111111111111111001111111111111111111111111111
11111111111111111100111111111111111111111111111
11111111111111111000111111111111111111111111111
11111111111111111101111111111111111111111111111
11111111111111111001111111111111111111111111111
11111111111111111100111111111111111111111111111
11111111111111111000111111111111111111111111111
11111111111111111101111111111111111111111111111
11111111111111111001111111111111111111111111111
11111111111111111100111111111111111111111111111
11111111111111111000111111111111111111111111111
11111111111111111101111111111111111111111111111
11111111111111111001111111111111111111111111111
11111111111111111100111111111111111111111111111
11111111111111111000111111111111111111111111111
11111111111111111101111111111111111111111111111
11111111111111111001111111111111111111111111111
11111111111111111100111111111111111111111111111
11111111111111111000111111111111111111111111111
11111111111111111101111111111111111111111111111
11111111111111111001111111111111111111111111111
11111111111111111101111111111111111111111111111
11111111111111111001111111111111111111111111111
11111111111111111100111111111111111111111111111
11111111111111111000111111111111111111111111111
11111111111111111101111111111111111111111111111
111111111111111110N1111111111111111111111111111
11111111111111111111111111111111111111111111111