NO              ./xpm/wall1.xpm

    WE     ./xpm/wall2.xpm

 SO ./xpm/wall3.xpm


EA ./xpm/wall4.xpm

F     108, 172   ,      1

C 22,   163,247
         
       
 11111111111111111111111111111111111111111111111111
 10000000000000010000000010000000000000000000000001
 10000000000000010000000020000000000000000000000001
 10010011111111111011111111111111111100001111111111
 11010000100000100001000001000000000100001
100000000000000000000000000000000000000001 
100010000000100001000010000000100000100001
100011111111111111111111111111111111101111
100000000000000100000100000000000000000001
100000000000000000000100000000000000000001
111111000000111110000111011111111111111111
100001000000100000000100000100000000000001
100001000001111100000100000100000000000001
100001111001000100000100101110111111110001
100000001000000100000100100000001000010001
100000011111000100000100000000001000000001
100000010000000100000111111111111001111111
100000010000000100000000000000001000000001
100000010001111100000000000000001111000001
100000010000000000000000000000000001000001
100000000001000000000000000000000001000001
100000011111000000000000010000000001000001
10000000000000000000000001000000000100S001
100000000000000000000000000000000000000001
111111111111111111110111111111111111111111
                 1000001
                 1000001
                 1100111
                 1110011
                 1111111